00000000000000000000
00011211111111111000
00011111111111111000
00011111111111111000
00011111111111111000
00000000000000000000