~~~~~~~~~~~~~~~~~~~~~~~~~~~~~~~~~~~~~~~~
~~~~~~1R1R1R1R1R1R1R1R1R1R1R1R1R1R~~~~~~
~~~~~~1R2R2R2R2R2R2R2R2R2R2R2R2R1R~~~~~~
~~~~~~1R2R2R2R2R2R2R2R2R2R2R2R2R1R~~~~~~
~~~~~~1R1R1R1R1R1R1R1R1R1R1R1R1R1R~~~~~~
~~~~~~~~~~~~~~~~~~~~~~~~~~~~~~~~~~~~~~~~